tortilla	Word	Filler
omplero 	Nonword	Filler
balloon	Word	Filler
umbrella	Word	Filler
glaple	Nonword	Filler
gompy	Nonword	Filler
bamboo	Word	Filler
fossil	Word	S-Final
pidbar	Nonword	Filler
darkroom	Word	Filler
gippelfraw	Nonword	Filler
dinosaur	Word	S-Final
lumber	Word	Filler
cashier	Word	SH-Final
tingora	Nonword	Filler
rindner	Nonword	Filler
candy	Word	Filler
theatre	Word	Filler
cockpit	Word	Filler
namittle	Nonword	Filler
shelter	Word	SH-Initial
hintarber 	Nonword	Filler
ladder	Word	Filler
darnat	Nonword	Filler
deoma	Nonword	Filler
ripnem	Nonword	Filler
traffic	Word	Filler
balrop	Nonword	Filler
golthin	Nonword	Filler
motpem	Nonword	Filler
hibernation	Word	SH-Final
hammertrent	Nonword	Filler
brochure	Word	SH-Final
rudle	Nonword	Filler
cradle	Word	Filler
missile	Word	S-Final
tello	Nonword	Filler
cushion	Word	SH-Final
prickpor	Nonword	Filler
shoplifter	Word	SH-Initial
thorkwift	Nonword	Filler
potha	Nonword	Filler
mannequin	Word	Filler
roppet	Nonword	Filler
kempel	Nonword	Filler
tissue	Word	SH-Final
brahata	Nonword	Filler
nartomy	Nonword	Filler
eruption	Word	SH-Final
teerell	Nonword	Filler
galaxy	Word	S-Final
apolm	Nonword	Filler
mopial	Nonword	Filler
cabin	Word	Filler
danoor	Nonword	Filler
thragkole	Nonword	Filler
kowack	Nonword	Filler
concert	Word	S-Final
noler	Nonword	Filler
dryer	Word	Filler
roggel	Nonword	Filler
talell	Nonword	Filler
yovernon	Nonword	Filler
bawapeet 	Nonword	Filler
helicopter	Word	Filler
nometin	Nonword	Filler
pencil	Word	S-Final
arnuff	Nonword	Filler
tadpole	Word	Filler
kire	Nonword	Filler
doorbell	Word	Filler
igoldion 	Nonword	Filler
currency	Word	S-Final
nonifem	Nonword	Filler
toygaw	Nonword	Filler
wogim	Nonword	Filler
napkin	Word	Filler
castle	Word	S-Final
rigloriem	Nonword	Filler
inoret	Nonword	Filler
hovear	Nonword	Filler
foter	Nonword	Filler
gittle	Nonword	Filler
calendar	Word	Filler
parachute	Word	SH-Final
mogmet	Nonword	Filler
sugar	Word	SH-Initial
lightning	Word	Filler
tirack	Nonword	Filler
bambany	Nonword	Filler
nepow	Nonword	Filler
meadow	Word	Filler
neproyave	Nonword	Filler
wekker	Nonword	Filler
ponytail	Word	Filler
teygot	Nonword	Filler
shoulder	Word	SH-Initial
klogodar 	Nonword	Filler
cowboy	Word	Filler
pickpat	Nonword	Filler
shampoo	Word	SH-Initial
tovey	Nonword	Filler
tuckib	Nonword	Filler
blial	Nonword	Filler
lindel 	Nonword	Filler
tayade	Nonword	Filler
rinbel	Nonword	Filler
gamtee	Nonword	Filler
arafimp	Nonword	Filler
pluepelai 	Nonword	Filler
talot	Nonword	Filler
pammin	Nonword	Filler
tire	Word	Filler
radadub	Nonword	Filler
tassel	Word	S-Final
feather	Word	Filler
graffiti	Word	Filler
iglopad	Nonword	Filler
hagrant	Nonword	Filler
dancer	Word	S-Final
apple	Word	Filler
antenna	Word	Filler
fingerprint	Word	Filler
monsoon	Word	S-Final
referee	Word	Filler
librarian	Word	Filler
gallmit	Nonword	Filler
shiny	Word	SH-Initial
prithet	Nonword	Filler
tinogail	Nonword	Filler
buckle	Word	Filler
gondola	Word	Filler
chandelier	Word	SH-Initial
impomo	Nonword	Filler
tractor	Word	Filler
minivan	Word	Filler
bimobel 	Nonword	Filler
goming	Nonword	Filler
tutrewy	Nonword	Filler
croissant	Word	S-Final
iddle	Nonword	Filler
faucet	Word	S-Final
painter	Word	Filler
mural	Word	Filler
whistle	Word	S-Final
follipocktel	Nonword	Filler
nidol	Nonword	Filler
teapot	Word	Filler
butterfly	Word	Filler
popcorn	Word	Filler
elephant	Word	Filler
kimmer	Nonword	Filler
pomto	Nonword	Filler
cutlery	Word	Filler
acrobat	Word	Filler
carousel	Word	S-Final
tirrenper	Nonword	Filler
curtsy	Word	S-Final
acorn	Word	Filler
bipar	Nonword	Filler
peltlon	Nonword	Filler
ladle	Word	Filler
patient	Word	SH-Final
giptern	Nonword	Filler
weatherman	Word	Filler
shovel	Word	SH-Initial
piano	Word	Filler
pharmacy	Word	S-Final
goalie	Word	Filler
microwave	Word	Filler
shadow	Word	SH-Initial
collar	Word	Filler
bettle	Nonword	Filler
auction	Word	SH-Final
garlic	Word	Filler
theerheb	Nonword	Filler
tuddom	Nonword	Filler
camel	Word	Filler
shareholder	Word	SH-Initial
tankfole	Nonword	Filler
ganla 	Nonword	Filler
taxi	Word	S-Final
theely	Nonword	Filler
table	Word	Filler
tepple	Nonword	Filler
diamond	Word	Filler
cursor	Word	S-Final
movie	Word	Filler
poltira	Nonword	Filler
poara	Nonword	Filler
timmer	Nonword	Filler
omelet	Word	Filler
lefeloo	Nonword	Filler
gorder	Nonword	Filler
wapteep	Nonword	Filler
medicine	Word	S-Final
motel	Word	Filler
campfire	Word	Filler
tunnel	Word	Filler
usher	Word	SH-Final
