garlic	Word	Filler
lefeloo	Nonword	Filler
theely	Nonword	Filler
theatre	Word	Filler
balloon	Word	Filler
bawapeet 	Nonword	Filler
apple	Word	Filler
nartomy	Nonword	Filler
bamboo	Word	Filler
arnuff	Nonword	Filler
pickpat	Nonword	Filler
teygot	Nonword	Filler
gittle	Nonword	Filler
tutrewy	Nonword	Filler
campfire	Word	Filler
graffiti	Word	Filler
hovear	Nonword	Filler
mopial	Nonword	Filler
galaxy	Word	S-Final
napkin	Word	Filler
kempel	Nonword	Filler
gorder	Nonword	Filler
cutlery	Word	Filler
minivan	Word	Filler
thorkwift	Nonword	Filler
tinogail	Nonword	Filler
elephant	Word	Filler
ladder	Word	Filler
gamtee	Nonword	Filler
tortilla	Word	Filler
meadow	Word	Filler
referee	Word	Filler
shampoo	Word	SH-Initial
tingora	Nonword	Filler
cursor	Word	S-Final
bambany	Nonword	Filler
fingerprint	Word	Filler
carousel	Word	S-Final
hagrant	Nonword	Filler
neproyave	Nonword	Filler
rinbel	Nonword	Filler
croissant	Word	S-Final
omplero 	Nonword	Filler
darkroom	Word	Filler
bettle	Nonword	Filler
tassel	Word	S-Final
tovey	Nonword	Filler
goalie	Word	Filler
rindner	Nonword	Filler
blial	Nonword	Filler
toygaw	Nonword	Filler
inoret	Nonword	Filler
patient	Word	SH-Final
painter	Word	Filler
monsoon	Word	S-Final
wogim	Nonword	Filler
gompy	Nonword	Filler
umbrella	Word	Filler
pluepelai 	Nonword	Filler
shoplifter	Word	SH-Initial
teerell	Nonword	Filler
lumber	Word	Filler
nepow	Nonword	Filler
golthin	Nonword	Filler
castle	Word	S-Final
pomto	Nonword	Filler
auction	Word	SH-Final
goming	Nonword	Filler
theerheb	Nonword	Filler
camel	Word	Filler
igoldion 	Nonword	Filler
rigloriem	Nonword	Filler
mogmet	Nonword	Filler
microwave	Word	Filler
poara	Nonword	Filler
cradle	Word	Filler
tuckib	Nonword	Filler
darnat	Nonword	Filler
dryer	Word	Filler
shadow	Word	SH-Initial
tirrenper	Nonword	Filler
gondola	Word	Filler
table	Word	Filler
eruption	Word	SH-Final
timmer	Nonword	Filler
feather	Word	Filler
brahata	Nonword	Filler
shoulder	Word	SH-Initial
wekker	Nonword	Filler
poltira	Nonword	Filler
ripnem	Nonword	Filler
cushion	Word	SH-Final
butterfly	Word	Filler
iglopad	Nonword	Filler
nonifem	Nonword	Filler
parachute	Word	SH-Final
thragkole	Nonword	Filler
librarian	Word	Filler
tello	Nonword	Filler
talell	Nonword	Filler
noler	Nonword	Filler
pammin	Nonword	Filler
acorn	Word	Filler
tayade	Nonword	Filler
concert	Word	S-Final
giptern	Nonword	Filler
pharmacy	Word	S-Final
talot	Nonword	Filler
foter	Nonword	Filler
tankfole	Nonword	Filler
kowack	Nonword	Filler
gallmit	Nonword	Filler
omelet	Word	Filler
currency	Word	S-Final
tepple	Nonword	Filler
bimobel 	Nonword	Filler
medicine	Word	S-Final
traffic	Word	Filler
deoma	Nonword	Filler
candy	Word	Filler
usher	Word	SH-Final
arafimp	Nonword	Filler
cowboy	Word	Filler
pidbar	Nonword	Filler
apolm	Nonword	Filler
nidol	Nonword	Filler
tadpole	Word	Filler
iddle	Nonword	Filler
motpem	Nonword	Filler
yovernon	Nonword	Filler
buckle	Word	Filler
shovel	Word	SH-Initial
calendar	Word	Filler
doorbell	Word	Filler
helicopter	Word	Filler
kire	Nonword	Filler
shelter	Word	SH-Initial
ponytail	Word	Filler
antenna	Word	Filler
prithet	Nonword	Filler
kimmer	Nonword	Filler
hibernation	Word	SH-Final
gippelfraw	Nonword	Filler
chandelier	Word	SH-Initial
roppet	Nonword	Filler
piano	Word	Filler
bipar	Nonword	Filler
popcorn	Word	Filler
wapteep	Nonword	Filler
pencil	Word	S-Final
collar	Word	Filler
sugar	Word	SH-Initial
radadub	Nonword	Filler
tuddom	Nonword	Filler
impomo	Nonword	Filler
curtsy	Word	S-Final
teapot	Word	Filler
prickpor	Nonword	Filler
movie	Word	Filler
brochure	Word	SH-Final
mannequin	Word	Filler
glaple	Nonword	Filler
mural	Word	Filler
fossil	Word	S-Final
roggel	Nonword	Filler
nometin	Nonword	Filler
cashier	Word	SH-Final
acrobat	Word	Filler
cockpit	Word	Filler
whistle	Word	S-Final
danoor	Nonword	Filler
motel	Word	Filler
taxi	Word	S-Final
balrop	Nonword	Filler
shiny	Word	SH-Initial
weatherman	Word	Filler
peltlon	Nonword	Filler
hintarber 	Nonword	Filler
tirack	Nonword	Filler
cabin	Word	Filler
tunnel	Word	Filler
tissue	Word	SH-Final
ladle	Word	Filler
lightning	Word	Filler
missile	Word	S-Final
tractor	Word	Filler
potha	Nonword	Filler
namittle	Nonword	Filler
ganla 	Nonword	Filler
shareholder	Word	SH-Initial
lindel 	Nonword	Filler
follipocktel	Nonword	Filler
klogodar 	Nonword	Filler
dinosaur	Word	S-Final
hammertrent	Nonword	Filler
faucet	Word	S-Final
diamond	Word	Filler
tire	Word	Filler
dancer	Word	S-Final
rudle	Nonword	Filler
