goalie	Word	Filler
dryer	Word	Filler
microwave	Word	Filler
pammin	Nonword	Filler
iddle	Nonword	Filler
wogim	Nonword	Filler
rinbel	Nonword	Filler
cowboy	Word	Filler
tepple	Nonword	Filler
nartomy	Nonword	Filler
hammertrent	Nonword	Filler
whistle	Word	S-Final
doorbell	Word	Filler
nidol	Nonword	Filler
dancer	Word	S-Final
tankfole	Nonword	Filler
cutlery	Word	Filler
dinosaur	Word	S-Final
tuckib	Nonword	Filler
chandelier	Word	SH-Initial
feather	Word	Filler
campfire	Word	Filler
ganla 	Nonword	Filler
motel	Word	Filler
shovel	Word	SH-Initial
blial	Nonword	Filler
omplero 	Nonword	Filler
weatherman	Word	Filler
tinogail	Nonword	Filler
rigloriem	Nonword	Filler
lefeloo	Nonword	Filler
apolm	Nonword	Filler
shiny	Word	SH-Initial
calendar	Word	Filler
usher	Word	SH-Final
buckle	Word	Filler
umbrella	Word	Filler
eruption	Word	SH-Final
nometin	Nonword	Filler
kowack	Nonword	Filler
rudle	Nonword	Filler
neproyave	Nonword	Filler
elephant	Word	Filler
bamboo	Word	Filler
balrop	Nonword	Filler
tractor	Word	Filler
bipar	Nonword	Filler
ladder	Word	Filler
bimobel 	Nonword	Filler
shoplifter	Word	SH-Initial
tortilla	Word	Filler
goming	Nonword	Filler
theatre	Word	Filler
tire	Word	Filler
arafimp	Nonword	Filler
meadow	Word	Filler
roppet	Nonword	Filler
tunnel	Word	Filler
balloon	Word	Filler
golthin	Nonword	Filler
poltira	Nonword	Filler
glaple	Nonword	Filler
arnuff	Nonword	Filler
antenna	Word	Filler
gallmit	Nonword	Filler
pencil	Word	S-Final
nonifem	Nonword	Filler
danoor	Nonword	Filler
tissue	Word	SH-Final
tirrenper	Nonword	Filler
popcorn	Word	Filler
omelet	Word	Filler
timmer	Nonword	Filler
shelter	Word	SH-Initial
lumber	Word	Filler
fingerprint	Word	Filler
potha	Nonword	Filler
kire	Nonword	Filler
medicine	Word	S-Final
theerheb	Nonword	Filler
tayade	Nonword	Filler
croissant	Word	S-Final
tuddom	Nonword	Filler
apple	Word	Filler
poara	Nonword	Filler
carousel	Word	S-Final
table	Word	Filler
shadow	Word	SH-Initial
cockpit	Word	Filler
prickpor	Nonword	Filler
hovear	Nonword	Filler
movie	Word	Filler
cursor	Word	S-Final
igoldion 	Nonword	Filler
missile	Word	S-Final
mannequin	Word	Filler
curtsy	Word	S-Final
pluepelai 	Nonword	Filler
yovernon	Nonword	Filler
prithet	Nonword	Filler
lightning	Word	Filler
theely	Nonword	Filler
currency	Word	S-Final
pomto	Nonword	Filler
bambany	Nonword	Filler
gondola	Word	Filler
deoma	Nonword	Filler
bettle	Nonword	Filler
mogmet	Nonword	Filler
gittle	Nonword	Filler
brahata	Nonword	Filler
ponytail	Word	Filler
candy	Word	Filler
motpem	Nonword	Filler
namittle	Nonword	Filler
lindel 	Nonword	Filler
darkroom	Word	Filler
auction	Word	SH-Final
diamond	Word	Filler
napkin	Word	Filler
darnat	Nonword	Filler
follipocktel	Nonword	Filler
brochure	Word	SH-Final
giptern	Nonword	Filler
mural	Word	Filler
shoulder	Word	SH-Initial
ripnem	Nonword	Filler
referee	Word	Filler
toygaw	Nonword	Filler
foter	Nonword	Filler
cabin	Word	Filler
talell	Nonword	Filler
helicopter	Word	Filler
teapot	Word	Filler
cradle	Word	Filler
tello	Nonword	Filler
kempel	Nonword	Filler
ladle	Word	Filler
gorder	Nonword	Filler
taxi	Word	S-Final
wekker	Nonword	Filler
kimmer	Nonword	Filler
inoret	Nonword	Filler
roggel	Nonword	Filler
iglopad	Nonword	Filler
gippelfraw	Nonword	Filler
gamtee	Nonword	Filler
tingora	Nonword	Filler
faucet	Word	S-Final
impomo	Nonword	Filler
painter	Word	Filler
mopial	Nonword	Filler
peltlon	Nonword	Filler
bawapeet 	Nonword	Filler
hibernation	Word	SH-Final
tutrewy	Nonword	Filler
monsoon	Word	S-Final
teygot	Nonword	Filler
garlic	Word	Filler
librarian	Word	Filler
tassel	Word	S-Final
pickpat	Nonword	Filler
collar	Word	Filler
graffiti	Word	Filler
butterfly	Word	Filler
hintarber 	Nonword	Filler
traffic	Word	Filler
nepow	Nonword	Filler
gompy	Nonword	Filler
tirack	Nonword	Filler
rindner	Nonword	Filler
minivan	Word	Filler
wapteep	Nonword	Filler
teerell	Nonword	Filler
castle	Word	S-Final
acorn	Word	Filler
thorkwift	Nonword	Filler
concert	Word	S-Final
tadpole	Word	Filler
pharmacy	Word	S-Final
camel	Word	Filler
sugar	Word	SH-Initial
noler	Nonword	Filler
fossil	Word	S-Final
hagrant	Nonword	Filler
galaxy	Word	S-Final
thragkole	Nonword	Filler
klogodar 	Nonword	Filler
cushion	Word	SH-Final
acrobat	Word	Filler
cashier	Word	SH-Final
piano	Word	Filler
radadub	Nonword	Filler
parachute	Word	SH-Final
pidbar	Nonword	Filler
shampoo	Word	SH-Initial
talot	Nonword	Filler
patient	Word	SH-Final
tovey	Nonword	Filler
shareholder	Word	SH-Initial
