popcorn	Word	Filler
gittle	Nonword	Filler
cutlery	Word	Filler
bipar	Nonword	Filler
gorder	Nonword	Filler
teygot	Nonword	Filler
shareholder	Word	SH-Initial
bimobel 	Nonword	Filler
talell	Nonword	Filler
ripnem	Nonword	Filler
goalie	Word	Filler
weatherman	Word	Filler
mogmet	Nonword	Filler
tovey	Nonword	Filler
shoplifter	Word	SH-Initial
lefeloo	Nonword	Filler
cockpit	Word	Filler
tractor	Word	Filler
gamtee	Nonword	Filler
wogim	Nonword	Filler
thragkole	Nonword	Filler
shovel	Word	SH-Initial
nepow	Nonword	Filler
missile	Word	S-Final
elephant	Word	Filler
hagrant	Nonword	Filler
camel	Word	Filler
inoret	Nonword	Filler
cabin	Word	Filler
doorbell	Word	Filler
tadpole	Word	Filler
talot	Nonword	Filler
darnat	Nonword	Filler
chandelier	Word	SH-Initial
cowboy	Word	Filler
noler	Nonword	Filler
goming	Nonword	Filler
omelet	Word	Filler
glaple	Nonword	Filler
piano	Word	Filler
hovear	Nonword	Filler
acorn	Word	Filler
tuckib	Nonword	Filler
theatre	Word	Filler
tutrewy	Nonword	Filler
shampoo	Word	SH-Initial
arafimp	Nonword	Filler
toygaw	Nonword	Filler
arnuff	Nonword	Filler
feather	Word	Filler
nidol	Nonword	Filler
buckle	Word	Filler
impomo	Nonword	Filler
dryer	Word	Filler
igoldion 	Nonword	Filler
shiny	Word	SH-Initial
pickpat	Nonword	Filler
radadub	Nonword	Filler
nartomy	Nonword	Filler
concert	Word	S-Final
nometin	Nonword	Filler
balrop	Nonword	Filler
klogodar 	Nonword	Filler
ponytail	Word	Filler
dancer	Word	S-Final
garlic	Word	Filler
darkroom	Word	Filler
teapot	Word	Filler
pammin	Nonword	Filler
hintarber 	Nonword	Filler
motpem	Nonword	Filler
tankfole	Nonword	Filler
tirack	Nonword	Filler
mural	Word	Filler
pharmacy	Word	S-Final
iglopad	Nonword	Filler
neproyave	Nonword	Filler
timmer	Nonword	Filler
eruption	Word	SH-Final
tortilla	Word	Filler
currency	Word	S-Final
bawapeet 	Nonword	Filler
curtsy	Word	S-Final
poara	Nonword	Filler
lightning	Word	Filler
peltlon	Nonword	Filler
giptern	Nonword	Filler
tassel	Word	S-Final
tingora	Nonword	Filler
tuddom	Nonword	Filler
apolm	Nonword	Filler
faucet	Word	S-Final
acrobat	Word	Filler
carousel	Word	S-Final
bettle	Nonword	Filler
cushion	Word	SH-Final
hammertrent	Nonword	Filler
shadow	Word	SH-Initial
danoor	Nonword	Filler
roggel	Nonword	Filler
usher	Word	SH-Final
teerell	Nonword	Filler
potha	Nonword	Filler
painter	Word	Filler
balloon	Word	Filler
butterfly	Word	Filler
poltira	Nonword	Filler
medicine	Word	S-Final
prithet	Nonword	Filler
gompy	Nonword	Filler
follipocktel	Nonword	Filler
campfire	Word	Filler
lindel 	Nonword	Filler
antenna	Word	Filler
kempel	Nonword	Filler
tello	Nonword	Filler
tirrenper	Nonword	Filler
fingerprint	Word	Filler
whistle	Word	S-Final
tunnel	Word	Filler
cursor	Word	S-Final
apple	Word	Filler
rudle	Nonword	Filler
kimmer	Nonword	Filler
galaxy	Word	S-Final
namittle	Nonword	Filler
calendar	Word	Filler
rindner	Nonword	Filler
theely	Nonword	Filler
taxi	Word	S-Final
yovernon	Nonword	Filler
sugar	Word	SH-Initial
gippelfraw	Nonword	Filler
referee	Word	Filler
prickpor	Nonword	Filler
shelter	Word	SH-Initial
movie	Word	Filler
auction	Word	SH-Final
ganla 	Nonword	Filler
wapteep	Nonword	Filler
hibernation	Word	SH-Final
tayade	Nonword	Filler
pomto	Nonword	Filler
lumber	Word	Filler
mopial	Nonword	Filler
nonifem	Nonword	Filler
microwave	Word	Filler
gallmit	Nonword	Filler
graffiti	Word	Filler
thorkwift	Nonword	Filler
ladder	Word	Filler
dinosaur	Word	S-Final
kire	Nonword	Filler
diamond	Word	Filler
librarian	Word	Filler
rinbel	Nonword	Filler
parachute	Word	SH-Final
bambany	Nonword	Filler
motel	Word	Filler
ladle	Word	Filler
deoma	Nonword	Filler
collar	Word	Filler
napkin	Word	Filler
tissue	Word	SH-Final
foter	Nonword	Filler
rigloriem	Nonword	Filler
traffic	Word	Filler
wekker	Nonword	Filler
kowack	Nonword	Filler
brahata	Nonword	Filler
omplero 	Nonword	Filler
umbrella	Word	Filler
bamboo	Word	Filler
minivan	Word	Filler
pluepelai 	Nonword	Filler
croissant	Word	S-Final
mannequin	Word	Filler
helicopter	Word	Filler
tepple	Nonword	Filler
meadow	Word	Filler
shoulder	Word	SH-Initial
pidbar	Nonword	Filler
tinogail	Nonword	Filler
cradle	Word	Filler
patient	Word	SH-Final
table	Word	Filler
gondola	Word	Filler
castle	Word	S-Final
iddle	Nonword	Filler
candy	Word	Filler
monsoon	Word	S-Final
tire	Word	Filler
fossil	Word	S-Final
blial	Nonword	Filler
golthin	Nonword	Filler
brochure	Word	SH-Final
theerheb	Nonword	Filler
pencil	Word	S-Final
roppet	Nonword	Filler
cashier	Word	SH-Final
