bipar	Nonword	Filler
tractor	Word	Filler
calendar	Word	Filler
prickpor	Nonword	Filler
hagrant	Nonword	Filler
tunnel	Word	Filler
thragkole	Nonword	Filler
darkroom	Word	Filler
namittle	Nonword	Filler
tuckib	Nonword	Filler
faucet	Word	S-Final
acrobat	Word	Filler
whistle	Word	S-Final
kowack	Nonword	Filler
kire	Nonword	Filler
rinbel	Nonword	Filler
graffiti	Word	Filler
tirrenper	Nonword	Filler
pharmacy	Word	S-Final
feather	Word	Filler
klogodar 	Nonword	Filler
shadow	Word	SH-Initial
rudle	Nonword	Filler
balloon	Word	Filler
pencil	Word	S-Final
gompy	Nonword	Filler
fingerprint	Word	Filler
iddle	Nonword	Filler
microwave	Word	Filler
shiny	Word	SH-Initial
foter	Nonword	Filler
nepow	Nonword	Filler
teygot	Nonword	Filler
radadub	Nonword	Filler
poltira	Nonword	Filler
goalie	Word	Filler
elephant	Word	Filler
tello	Nonword	Filler
cursor	Word	S-Final
toygaw	Nonword	Filler
danoor	Nonword	Filler
teerell	Nonword	Filler
arnuff	Nonword	Filler
iglopad	Nonword	Filler
darnat	Nonword	Filler
gippelfraw	Nonword	Filler
parachute	Word	SH-Final
bettle	Nonword	Filler
shoplifter	Word	SH-Initial
nometin	Nonword	Filler
buckle	Word	Filler
bamboo	Word	Filler
pomto	Nonword	Filler
brochure	Word	SH-Final
tingora	Nonword	Filler
lumber	Word	Filler
tadpole	Word	Filler
shareholder	Word	SH-Initial
bimobel 	Nonword	Filler
motel	Word	Filler
eruption	Word	SH-Final
tankfole	Nonword	Filler
campfire	Word	Filler
movie	Word	Filler
pidbar	Nonword	Filler
tayade	Nonword	Filler
diamond	Word	Filler
wogim	Nonword	Filler
galaxy	Word	S-Final
tuddom	Nonword	Filler
referee	Word	Filler
rindner	Nonword	Filler
roppet	Nonword	Filler
pickpat	Nonword	Filler
nidol	Nonword	Filler
noler	Nonword	Filler
balrop	Nonword	Filler
wekker	Nonword	Filler
doorbell	Word	Filler
tassel	Word	S-Final
hintarber 	Nonword	Filler
acorn	Word	Filler
lindel 	Nonword	Filler
table	Word	Filler
goming	Nonword	Filler
popcorn	Word	Filler
librarian	Word	Filler
omplero 	Nonword	Filler
sugar	Word	SH-Initial
nonifem	Nonword	Filler
shoulder	Word	SH-Initial
talell	Nonword	Filler
neproyave	Nonword	Filler
tortilla	Word	Filler
glaple	Nonword	Filler
tirack	Nonword	Filler
lightning	Word	Filler
kimmer	Nonword	Filler
wapteep	Nonword	Filler
shovel	Word	SH-Initial
traffic	Word	Filler
gorder	Nonword	Filler
tinogail	Nonword	Filler
dryer	Word	Filler
chandelier	Word	SH-Initial
minivan	Word	Filler
lefeloo	Nonword	Filler
camel	Word	Filler
croissant	Word	S-Final
helicopter	Word	Filler
castle	Word	S-Final
meadow	Word	Filler
bawapeet 	Nonword	Filler
missile	Word	S-Final
antenna	Word	Filler
apple	Word	Filler
arafimp	Nonword	Filler
peltlon	Nonword	Filler
cowboy	Word	Filler
timmer	Nonword	Filler
auction	Word	SH-Final
theerheb	Nonword	Filler
ponytail	Word	Filler
potha	Nonword	Filler
teapot	Word	Filler
fossil	Word	S-Final
poara	Nonword	Filler
cutlery	Word	Filler
deoma	Nonword	Filler
kempel	Nonword	Filler
tutrewy	Nonword	Filler
theely	Nonword	Filler
pluepelai 	Nonword	Filler
blial	Nonword	Filler
roggel	Nonword	Filler
shampoo	Word	SH-Initial
garlic	Word	Filler
tepple	Nonword	Filler
hammertrent	Nonword	Filler
weatherman	Word	Filler
talot	Nonword	Filler
ladle	Word	Filler
cashier	Word	SH-Final
hovear	Nonword	Filler
apolm	Nonword	Filler
candy	Word	Filler
piano	Word	Filler
dancer	Word	S-Final
ganla 	Nonword	Filler
collar	Word	Filler
inoret	Nonword	Filler
mural	Word	Filler
gondola	Word	Filler
giptern	Nonword	Filler
omelet	Word	Filler
cabin	Word	Filler
concert	Word	S-Final
cradle	Word	Filler
monsoon	Word	S-Final
ladder	Word	Filler
pammin	Nonword	Filler
mannequin	Word	Filler
patient	Word	SH-Final
umbrella	Word	Filler
tissue	Word	SH-Final
gamtee	Nonword	Filler
bambany	Nonword	Filler
cushion	Word	SH-Final
gittle	Nonword	Filler
ripnem	Nonword	Filler
shelter	Word	SH-Initial
butterfly	Word	Filler
brahata	Nonword	Filler
hibernation	Word	SH-Final
rigloriem	Nonword	Filler
usher	Word	SH-Final
mogmet	Nonword	Filler
motpem	Nonword	Filler
nartomy	Nonword	Filler
thorkwift	Nonword	Filler
napkin	Word	Filler
medicine	Word	S-Final
gallmit	Nonword	Filler
dinosaur	Word	S-Final
theatre	Word	Filler
taxi	Word	S-Final
impomo	Nonword	Filler
curtsy	Word	S-Final
prithet	Nonword	Filler
carousel	Word	S-Final
tovey	Nonword	Filler
igoldion 	Nonword	Filler
yovernon	Nonword	Filler
currency	Word	S-Final
golthin	Nonword	Filler
follipocktel	Nonword	Filler
cockpit	Word	Filler
painter	Word	Filler
tire	Word	Filler
mopial	Nonword	Filler
