cabin	Word	Filler
cradle	Word	Filler
librarian	Word	Filler
omelet	Word	Filler
arnuff	Nonword	Filler
mogmet	Nonword	Filler
prithet	Nonword	Filler
theerheb	Nonword	Filler
galaxy	Word	S-Final
poltira	Nonword	Filler
medicine	Word	S-Final
diamond	Word	Filler
blial	Nonword	Filler
helicopter	Word	Filler
balloon	Word	Filler
tadpole	Word	Filler
tepple	Nonword	Filler
minivan	Word	Filler
pluepelai 	Nonword	Filler
acrobat	Word	Filler
napkin	Word	Filler
teygot	Nonword	Filler
lindel 	Nonword	Filler
doorbell	Word	Filler
collar	Word	Filler
rinbel	Nonword	Filler
wekker	Nonword	Filler
roppet	Nonword	Filler
potha	Nonword	Filler
cutlery	Word	Filler
carousel	Word	S-Final
pidbar	Nonword	Filler
apolm	Nonword	Filler
curtsy	Word	S-Final
ripnem	Nonword	Filler
umbrella	Word	Filler
whistle	Word	S-Final
bambany	Nonword	Filler
castle	Word	S-Final
gittle	Nonword	Filler
faucet	Word	S-Final
peltlon	Nonword	Filler
deoma	Nonword	Filler
weatherman	Word	Filler
brahata	Nonword	Filler
table	Word	Filler
kempel	Nonword	Filler
motpem	Nonword	Filler
auction	Word	SH-Final
bettle	Nonword	Filler
balrop	Nonword	Filler
theely	Nonword	Filler
tirrenper	Nonword	Filler
golthin	Nonword	Filler
currency	Word	S-Final
radadub	Nonword	Filler
lumber	Word	Filler
giptern	Nonword	Filler
nartomy	Nonword	Filler
motel	Word	Filler
pammin	Nonword	Filler
namittle	Nonword	Filler
butterfly	Word	Filler
prickpor	Nonword	Filler
noler	Nonword	Filler
goalie	Word	Filler
shoulder	Word	SH-Initial
hagrant	Nonword	Filler
shoplifter	Word	SH-Initial
wapteep	Nonword	Filler
danoor	Nonword	Filler
missile	Word	S-Final
tirack	Nonword	Filler
roggel	Nonword	Filler
omplero 	Nonword	Filler
follipocktel	Nonword	Filler
nometin	Nonword	Filler
ladder	Word	Filler
gondola	Word	Filler
dancer	Word	S-Final
hammertrent	Nonword	Filler
shelter	Word	SH-Initial
bawapeet 	Nonword	Filler
brochure	Word	SH-Final
tortilla	Word	Filler
rigloriem	Nonword	Filler
calendar	Word	Filler
pickpat	Nonword	Filler
gippelfraw	Nonword	Filler
tayade	Nonword	Filler
parachute	Word	SH-Final
neproyave	Nonword	Filler
teapot	Word	Filler
hibernation	Word	SH-Final
mopial	Nonword	Filler
feather	Word	Filler
ponytail	Word	Filler
candy	Word	Filler
tunnel	Word	Filler
gamtee	Nonword	Filler
buckle	Word	Filler
tinogail	Nonword	Filler
cowboy	Word	Filler
iddle	Nonword	Filler
ladle	Word	Filler
klogodar 	Nonword	Filler
kowack	Nonword	Filler
antenna	Word	Filler
tello	Nonword	Filler
wogim	Nonword	Filler
sugar	Word	SH-Initial
tovey	Nonword	Filler
glaple	Nonword	Filler
chandelier	Word	SH-Initial
toygaw	Nonword	Filler
tingora	Nonword	Filler
lefeloo	Nonword	Filler
concert	Word	S-Final
garlic	Word	Filler
dinosaur	Word	S-Final
movie	Word	Filler
ganla 	Nonword	Filler
cashier	Word	SH-Final
camel	Word	Filler
goming	Nonword	Filler
thragkole	Nonword	Filler
bamboo	Word	Filler
dryer	Word	Filler
thorkwift	Nonword	Filler
pharmacy	Word	S-Final
gorder	Nonword	Filler
nepow	Nonword	Filler
popcorn	Word	Filler
shareholder	Word	SH-Initial
talell	Nonword	Filler
tutrewy	Nonword	Filler
pencil	Word	S-Final
foter	Nonword	Filler
gompy	Nonword	Filler
croissant	Word	S-Final
microwave	Word	Filler
timmer	Nonword	Filler
cursor	Word	S-Final
mannequin	Word	Filler
teerell	Nonword	Filler
cushion	Word	SH-Final
yovernon	Nonword	Filler
bipar	Nonword	Filler
impomo	Nonword	Filler
talot	Nonword	Filler
referee	Word	Filler
rudle	Nonword	Filler
tankfole	Nonword	Filler
inoret	Nonword	Filler
eruption	Word	SH-Final
acorn	Word	Filler
fossil	Word	S-Final
gallmit	Nonword	Filler
taxi	Word	S-Final
lightning	Word	Filler
shadow	Word	SH-Initial
piano	Word	Filler
tractor	Word	Filler
rindner	Nonword	Filler
theatre	Word	Filler
nonifem	Nonword	Filler
traffic	Word	Filler
elephant	Word	Filler
graffiti	Word	Filler
shiny	Word	SH-Initial
apple	Word	Filler
iglopad	Nonword	Filler
arafimp	Nonword	Filler
usher	Word	SH-Final
pomto	Nonword	Filler
monsoon	Word	S-Final
darkroom	Word	Filler
tassel	Word	S-Final
igoldion 	Nonword	Filler
nidol	Nonword	Filler
kire	Nonword	Filler
fingerprint	Word	Filler
tuckib	Nonword	Filler
cockpit	Word	Filler
bimobel 	Nonword	Filler
tissue	Word	SH-Final
poara	Nonword	Filler
patient	Word	SH-Final
painter	Word	Filler
campfire	Word	Filler
mural	Word	Filler
tuddom	Nonword	Filler
shovel	Word	SH-Initial
hovear	Nonword	Filler
darnat	Nonword	Filler
kimmer	Nonword	Filler
shampoo	Word	SH-Initial
tire	Word	Filler
hintarber 	Nonword	Filler
meadow	Word	Filler
