gompy	Nonword	Filler
umbrella	Word	Filler
traffic	Word	Filler
noler	Nonword	Filler
lindel 	Nonword	Filler
hammertrent	Nonword	Filler
nepow	Nonword	Filler
lightning	Word	Filler
librarian	Word	Filler
elephant	Word	Filler
apolm	Nonword	Filler
mannequin	Word	Filler
kimmer	Nonword	Filler
taxi	Word	S-Final
acorn	Word	Filler
glaple	Nonword	Filler
iglopad	Nonword	Filler
calendar	Word	Filler
mural	Word	Filler
cabin	Word	Filler
pickpat	Nonword	Filler
campfire	Word	Filler
minivan	Word	Filler
potha	Nonword	Filler
brahata	Nonword	Filler
curtsy	Word	S-Final
teapot	Word	Filler
collar	Word	Filler
tadpole	Word	Filler
iddle	Nonword	Filler
shoplifter	Word	SH-Initial
mopial	Nonword	Filler
cradle	Word	Filler
apple	Word	Filler
painter	Word	Filler
nidol	Nonword	Filler
tassel	Word	S-Final
namittle	Nonword	Filler
gamtee	Nonword	Filler
fossil	Word	S-Final
pammin	Nonword	Filler
cashier	Word	SH-Final
lefeloo	Nonword	Filler
bettle	Nonword	Filler
tissue	Word	SH-Final
antenna	Word	Filler
table	Word	Filler
bamboo	Word	Filler
theerheb	Nonword	Filler
cursor	Word	S-Final
rinbel	Nonword	Filler
missile	Word	S-Final
yovernon	Nonword	Filler
wapteep	Nonword	Filler
bipar	Nonword	Filler
faucet	Word	S-Final
toygaw	Nonword	Filler
tinogail	Nonword	Filler
poltira	Nonword	Filler
hagrant	Nonword	Filler
omplero 	Nonword	Filler
nometin	Nonword	Filler
pluepelai 	Nonword	Filler
chandelier	Word	SH-Initial
tovey	Nonword	Filler
tirack	Nonword	Filler
kire	Nonword	Filler
referee	Word	Filler
ripnem	Nonword	Filler
roppet	Nonword	Filler
tello	Nonword	Filler
meadow	Word	Filler
tirrenper	Nonword	Filler
dinosaur	Word	S-Final
talell	Nonword	Filler
monsoon	Word	S-Final
foter	Nonword	Filler
wekker	Nonword	Filler
castle	Word	S-Final
theely	Nonword	Filler
cockpit	Word	Filler
tutrewy	Nonword	Filler
camel	Word	Filler
balrop	Nonword	Filler
auction	Word	SH-Final
ponytail	Word	Filler
ladder	Word	Filler
acrobat	Word	Filler
dryer	Word	Filler
pharmacy	Word	S-Final
candy	Word	Filler
omelet	Word	Filler
kowack	Nonword	Filler
gondola	Word	Filler
poara	Nonword	Filler
patient	Word	SH-Final
klogodar 	Nonword	Filler
arnuff	Nonword	Filler
shampoo	Word	SH-Initial
peltlon	Nonword	Filler
fingerprint	Word	Filler
tuddom	Nonword	Filler
gittle	Nonword	Filler
follipocktel	Nonword	Filler
ladle	Word	Filler
shareholder	Word	SH-Initial
movie	Word	Filler
kempel	Nonword	Filler
mogmet	Nonword	Filler
gorder	Nonword	Filler
piano	Word	Filler
inoret	Nonword	Filler
tractor	Word	Filler
tayade	Nonword	Filler
tuckib	Nonword	Filler
gippelfraw	Nonword	Filler
radadub	Nonword	Filler
ganla 	Nonword	Filler
pencil	Word	S-Final
darnat	Nonword	Filler
arafimp	Nonword	Filler
theatre	Word	Filler
darkroom	Word	Filler
tortilla	Word	Filler
wogim	Nonword	Filler
usher	Word	SH-Final
buckle	Word	Filler
carousel	Word	S-Final
danoor	Nonword	Filler
doorbell	Word	Filler
parachute	Word	SH-Final
weatherman	Word	Filler
hovear	Nonword	Filler
tingora	Nonword	Filler
microwave	Word	Filler
cutlery	Word	Filler
shovel	Word	SH-Initial
rindner	Nonword	Filler
diamond	Word	Filler
bimobel 	Nonword	Filler
pomto	Nonword	Filler
garlic	Word	Filler
timmer	Nonword	Filler
giptern	Nonword	Filler
butterfly	Word	Filler
feather	Word	Filler
neproyave	Nonword	Filler
whistle	Word	S-Final
prithet	Nonword	Filler
hibernation	Word	SH-Final
prickpor	Nonword	Filler
pidbar	Nonword	Filler
nonifem	Nonword	Filler
roggel	Nonword	Filler
galaxy	Word	S-Final
hintarber 	Nonword	Filler
dancer	Word	S-Final
deoma	Nonword	Filler
graffiti	Word	Filler
cowboy	Word	Filler
currency	Word	S-Final
gallmit	Nonword	Filler
popcorn	Word	Filler
brochure	Word	SH-Final
tankfole	Nonword	Filler
shoulder	Word	SH-Initial
bambany	Nonword	Filler
bawapeet 	Nonword	Filler
shelter	Word	SH-Initial
napkin	Word	Filler
teygot	Nonword	Filler
talot	Nonword	Filler
croissant	Word	S-Final
balloon	Word	Filler
thragkole	Nonword	Filler
shiny	Word	SH-Initial
helicopter	Word	Filler
sugar	Word	SH-Initial
rigloriem	Nonword	Filler
shadow	Word	SH-Initial
lumber	Word	Filler
teerell	Nonword	Filler
golthin	Nonword	Filler
igoldion 	Nonword	Filler
cushion	Word	SH-Final
rudle	Nonword	Filler
tunnel	Word	Filler
motel	Word	Filler
concert	Word	S-Final
tepple	Nonword	Filler
eruption	Word	SH-Final
impomo	Nonword	Filler
goming	Nonword	Filler
medicine	Word	S-Final
tire	Word	Filler
motpem	Nonword	Filler
nartomy	Nonword	Filler
thorkwift	Nonword	Filler
blial	Nonword	Filler
goalie	Word	Filler
