glaple	Nonword	Filler
bawapeet 	Nonword	Filler
iglopad	Nonword	Filler
tractor	Word	Filler
tuddom	Nonword	Filler
foter	Nonword	Filler
minivan	Word	Filler
apple	Word	Filler
goalie	Word	Filler
gompy	Nonword	Filler
fingerprint	Word	Filler
tutrewy	Nonword	Filler
mannequin	Word	Filler
bipar	Nonword	Filler
camel	Word	Filler
tadpole	Word	Filler
lindel 	Nonword	Filler
librarian	Word	Filler
croissant	Word	S-Final
teygot	Nonword	Filler
cursor	Word	S-Final
theely	Nonword	Filler
tankfole	Nonword	Filler
thorkwift	Nonword	Filler
kowack	Nonword	Filler
napkin	Word	Filler
talot	Nonword	Filler
elephant	Word	Filler
noler	Nonword	Filler
iddle	Nonword	Filler
yovernon	Nonword	Filler
fossil	Word	S-Final
movie	Word	Filler
pomto	Nonword	Filler
brochure	Word	SH-Final
tingora	Nonword	Filler
hagrant	Nonword	Filler
rinbel	Nonword	Filler
poara	Nonword	Filler
buckle	Word	Filler
parachute	Word	SH-Final
timmer	Nonword	Filler
tello	Nonword	Filler
bambany	Nonword	Filler
curtsy	Word	S-Final
traffic	Word	Filler
prickpor	Nonword	Filler
shiny	Word	SH-Initial
hintarber 	Nonword	Filler
danoor	Nonword	Filler
neproyave	Nonword	Filler
hovear	Nonword	Filler
shadow	Word	SH-Initial
bamboo	Word	Filler
tirack	Nonword	Filler
popcorn	Word	Filler
collar	Word	Filler
theerheb	Nonword	Filler
motel	Word	Filler
doorbell	Word	Filler
dancer	Word	S-Final
mogmet	Nonword	Filler
tirrenper	Nonword	Filler
taxi	Word	S-Final
umbrella	Word	Filler
castle	Word	S-Final
cowboy	Word	Filler
potha	Nonword	Filler
rigloriem	Nonword	Filler
arafimp	Nonword	Filler
wekker	Nonword	Filler
dryer	Word	Filler
acrobat	Word	Filler
shampoo	Word	SH-Initial
ladle	Word	Filler
tortilla	Word	Filler
bimobel 	Nonword	Filler
kempel	Nonword	Filler
ripnem	Nonword	Filler
darnat	Nonword	Filler
candy	Word	Filler
pidbar	Nonword	Filler
chandelier	Word	SH-Initial
cabin	Word	Filler
rudle	Nonword	Filler
prithet	Nonword	Filler
cushion	Word	SH-Final
acorn	Word	Filler
lefeloo	Nonword	Filler
graffiti	Word	Filler
toygaw	Nonword	Filler
giptern	Nonword	Filler
cutlery	Word	Filler
talell	Nonword	Filler
teapot	Word	Filler
poltira	Nonword	Filler
apolm	Nonword	Filler
referee	Word	Filler
tassel	Word	S-Final
kimmer	Nonword	Filler
arnuff	Nonword	Filler
hammertrent	Nonword	Filler
brahata	Nonword	Filler
butterfly	Word	Filler
peltlon	Nonword	Filler
galaxy	Word	S-Final
wapteep	Nonword	Filler
calendar	Word	Filler
shareholder	Word	SH-Initial
antenna	Word	Filler
shoplifter	Word	SH-Initial
thragkole	Nonword	Filler
nonifem	Nonword	Filler
tayade	Nonword	Filler
ponytail	Word	Filler
auction	Word	SH-Final
kire	Nonword	Filler
inoret	Nonword	Filler
impomo	Nonword	Filler
nometin	Nonword	Filler
tire	Word	Filler
pencil	Word	S-Final
golthin	Nonword	Filler
microwave	Word	Filler
usher	Word	SH-Final
pickpat	Nonword	Filler
dinosaur	Word	S-Final
follipocktel	Nonword	Filler
balloon	Word	Filler
pammin	Nonword	Filler
omelet	Word	Filler
gittle	Nonword	Filler
concert	Word	S-Final
tovey	Nonword	Filler
balrop	Nonword	Filler
ladder	Word	Filler
shelter	Word	SH-Initial
teerell	Nonword	Filler
radadub	Nonword	Filler
namittle	Nonword	Filler
currency	Word	S-Final
deoma	Nonword	Filler
feather	Word	Filler
blial	Nonword	Filler
omplero 	Nonword	Filler
gallmit	Nonword	Filler
campfire	Word	Filler
tissue	Word	SH-Final
helicopter	Word	Filler
weatherman	Word	Filler
tuckib	Nonword	Filler
shovel	Word	SH-Initial
bettle	Nonword	Filler
tunnel	Word	Filler
table	Word	Filler
pluepelai 	Nonword	Filler
klogodar 	Nonword	Filler
nepow	Nonword	Filler
tepple	Nonword	Filler
goming	Nonword	Filler
darkroom	Word	Filler
meadow	Word	Filler
carousel	Word	S-Final
nidol	Nonword	Filler
roppet	Nonword	Filler
diamond	Word	Filler
mopial	Nonword	Filler
cockpit	Word	Filler
monsoon	Word	S-Final
cradle	Word	Filler
roggel	Nonword	Filler
cashier	Word	SH-Final
tinogail	Nonword	Filler
piano	Word	Filler
faucet	Word	S-Final
lumber	Word	Filler
sugar	Word	SH-Initial
gorder	Nonword	Filler
eruption	Word	SH-Final
gippelfraw	Nonword	Filler
missile	Word	S-Final
rindner	Nonword	Filler
whistle	Word	S-Final
gamtee	Nonword	Filler
mural	Word	Filler
nartomy	Nonword	Filler
painter	Word	Filler
hibernation	Word	SH-Final
theatre	Word	Filler
ganla 	Nonword	Filler
patient	Word	SH-Final
wogim	Nonword	Filler
motpem	Nonword	Filler
lightning	Word	Filler
shoulder	Word	SH-Initial
garlic	Word	Filler
pharmacy	Word	S-Final
igoldion 	Nonword	Filler
medicine	Word	S-Final
gondola	Word	Filler
