goalie	Word	Filler
wogim	Nonword	Filler
glaple	Nonword	Filler
mogmet	Nonword	Filler
klogodar 	Nonword	Filler
helicopter	Word	Filler
elephant	Word	Filler
theatre	Word	Filler
kowack	Nonword	Filler
lefeloo	Nonword	Filler
referee	Word	Filler
talell	Nonword	Filler
tirrenper	Nonword	Filler
gippelfraw	Nonword	Filler
painter	Word	Filler
napkin	Word	Filler
yovernon	Nonword	Filler
lumber	Word	Filler
toygaw	Nonword	Filler
shiny	Word	SH-Initial
tire	Word	Filler
gompy	Nonword	Filler
pencil	Word	S-Final
golthin	Nonword	Filler
collar	Word	Filler
traffic	Word	Filler
rigloriem	Nonword	Filler
theely	Nonword	Filler
tayade	Nonword	Filler
medicine	Word	S-Final
camel	Word	Filler
hovear	Nonword	Filler
calendar	Word	Filler
concert	Word	S-Final
gittle	Nonword	Filler
teapot	Word	Filler
follipocktel	Nonword	Filler
tingora	Nonword	Filler
shareholder	Word	SH-Initial
neproyave	Nonword	Filler
deoma	Nonword	Filler
umbrella	Word	Filler
tortilla	Word	Filler
acrobat	Word	Filler
gorder	Nonword	Filler
tadpole	Word	Filler
cushion	Word	SH-Final
theerheb	Nonword	Filler
shoulder	Word	SH-Initial
movie	Word	Filler
dancer	Word	S-Final
fingerprint	Word	Filler
apolm	Nonword	Filler
poara	Nonword	Filler
cockpit	Word	Filler
wapteep	Nonword	Filler
thragkole	Nonword	Filler
namittle	Nonword	Filler
tinogail	Nonword	Filler
antenna	Word	Filler
cashier	Word	SH-Final
gondola	Word	Filler
whistle	Word	S-Final
thorkwift	Nonword	Filler
shadow	Word	SH-Initial
feather	Word	Filler
croissant	Word	S-Final
arafimp	Nonword	Filler
usher	Word	SH-Final
candy	Word	Filler
darnat	Nonword	Filler
fossil	Word	S-Final
apple	Word	Filler
taxi	Word	S-Final
garlic	Word	Filler
acorn	Word	Filler
chandelier	Word	SH-Initial
tuddom	Nonword	Filler
tankfole	Nonword	Filler
meadow	Word	Filler
impomo	Nonword	Filler
bipar	Nonword	Filler
iddle	Nonword	Filler
radadub	Nonword	Filler
tirack	Nonword	Filler
darkroom	Word	Filler
pickpat	Nonword	Filler
tunnel	Word	Filler
lightning	Word	Filler
shoplifter	Word	SH-Initial
pluepelai 	Nonword	Filler
ponytail	Word	Filler
monsoon	Word	S-Final
butterfly	Word	Filler
pidbar	Nonword	Filler
dinosaur	Word	S-Final
prithet	Nonword	Filler
kempel	Nonword	Filler
piano	Word	Filler
bettle	Nonword	Filler
gallmit	Nonword	Filler
buckle	Word	Filler
microwave	Word	Filler
nartomy	Nonword	Filler
iglopad	Nonword	Filler
bimobel 	Nonword	Filler
roggel	Nonword	Filler
omplero 	Nonword	Filler
teygot	Nonword	Filler
foter	Nonword	Filler
peltlon	Nonword	Filler
cabin	Word	Filler
diamond	Word	Filler
currency	Word	S-Final
bambany	Nonword	Filler
tractor	Word	Filler
pammin	Nonword	Filler
rindner	Nonword	Filler
giptern	Nonword	Filler
tutrewy	Nonword	Filler
curtsy	Word	S-Final
brahata	Nonword	Filler
tissue	Word	SH-Final
mannequin	Word	Filler
eruption	Word	SH-Final
librarian	Word	Filler
ganla 	Nonword	Filler
tepple	Nonword	Filler
tovey	Nonword	Filler
pharmacy	Word	S-Final
kire	Nonword	Filler
ladle	Word	Filler
tello	Nonword	Filler
blial	Nonword	Filler
lindel 	Nonword	Filler
teerell	Nonword	Filler
hintarber 	Nonword	Filler
castle	Word	S-Final
cradle	Word	Filler
dryer	Word	Filler
gamtee	Nonword	Filler
rinbel	Nonword	Filler
prickpor	Nonword	Filler
patient	Word	SH-Final
talot	Nonword	Filler
carousel	Word	S-Final
nonifem	Nonword	Filler
shovel	Word	SH-Initial
bamboo	Word	Filler
timmer	Nonword	Filler
mopial	Nonword	Filler
nometin	Nonword	Filler
ladder	Word	Filler
weatherman	Word	Filler
cutlery	Word	Filler
graffiti	Word	Filler
ripnem	Nonword	Filler
goming	Nonword	Filler
sugar	Word	SH-Initial
noler	Nonword	Filler
kimmer	Nonword	Filler
faucet	Word	S-Final
table	Word	Filler
omelet	Word	Filler
igoldion 	Nonword	Filler
hibernation	Word	SH-Final
campfire	Word	Filler
danoor	Nonword	Filler
hammertrent	Nonword	Filler
nepow	Nonword	Filler
wekker	Nonword	Filler
poltira	Nonword	Filler
minivan	Word	Filler
bawapeet 	Nonword	Filler
tassel	Word	S-Final
balrop	Nonword	Filler
brochure	Word	SH-Final
tuckib	Nonword	Filler
mural	Word	Filler
nidol	Nonword	Filler
rudle	Nonword	Filler
cursor	Word	S-Final
pomto	Nonword	Filler
motpem	Nonword	Filler
cowboy	Word	Filler
motel	Word	Filler
doorbell	Word	Filler
inoret	Nonword	Filler
galaxy	Word	S-Final
hagrant	Nonword	Filler
auction	Word	SH-Final
balloon	Word	Filler
shampoo	Word	SH-Initial
roppet	Nonword	Filler
parachute	Word	SH-Final
popcorn	Word	Filler
shelter	Word	SH-Initial
potha	Nonword	Filler
missile	Word	S-Final
arnuff	Nonword	Filler
