dryer	Word	Filler
darnat	Nonword	Filler
thragkole	Nonword	Filler
teerell	Nonword	Filler
traffic	Word	Filler
movie	Word	Filler
chandelier	Word	SH-Initial
peltlon	Nonword	Filler
tello	Nonword	Filler
wekker	Nonword	Filler
blial	Nonword	Filler
parachute	Word	SH-Final
hintarber 	Nonword	Filler
shovel	Word	SH-Initial
theerheb	Nonword	Filler
eruption	Word	SH-Final
tuckib	Nonword	Filler
toygaw	Nonword	Filler
deoma	Nonword	Filler
motel	Word	Filler
nidol	Nonword	Filler
cutlery	Word	Filler
pammin	Nonword	Filler
potha	Nonword	Filler
minivan	Word	Filler
igoldion 	Nonword	Filler
shampoo	Word	SH-Initial
tire	Word	Filler
yovernon	Nonword	Filler
auction	Word	SH-Final
weatherman	Word	Filler
tankfole	Nonword	Filler
rudle	Nonword	Filler
bawapeet 	Nonword	Filler
theatre	Word	Filler
hagrant	Nonword	Filler
pomto	Nonword	Filler
doorbell	Word	Filler
gittle	Nonword	Filler
croissant	Word	S-Final
gompy	Nonword	Filler
foter	Nonword	Filler
iddle	Nonword	Filler
ripnem	Nonword	Filler
tirack	Nonword	Filler
bimobel 	Nonword	Filler
tayade	Nonword	Filler
darkroom	Word	Filler
kowack	Nonword	Filler
pidbar	Nonword	Filler
currency	Word	S-Final
ganla 	Nonword	Filler
cabin	Word	Filler
campfire	Word	Filler
motpem	Nonword	Filler
roggel	Nonword	Filler
pickpat	Nonword	Filler
tassel	Word	S-Final
kire	Nonword	Filler
nepow	Nonword	Filler
cowboy	Word	Filler
garlic	Word	Filler
tutrewy	Nonword	Filler
brochure	Word	SH-Final
kimmer	Nonword	Filler
ponytail	Word	Filler
lefeloo	Nonword	Filler
hibernation	Word	SH-Final
timmer	Nonword	Filler
pencil	Word	S-Final
klogodar 	Nonword	Filler
umbrella	Word	Filler
tingora	Nonword	Filler
curtsy	Word	S-Final
antenna	Word	Filler
rindner	Nonword	Filler
shadow	Word	SH-Initial
referee	Word	Filler
omelet	Word	Filler
hovear	Nonword	Filler
camel	Word	Filler
cockpit	Word	Filler
nartomy	Nonword	Filler
gorder	Nonword	Filler
shareholder	Word	SH-Initial
lightning	Word	Filler
pharmacy	Word	S-Final
talot	Nonword	Filler
dinosaur	Word	S-Final
balloon	Word	Filler
noler	Nonword	Filler
faucet	Word	S-Final
kempel	Nonword	Filler
fingerprint	Word	Filler
teapot	Word	Filler
collar	Word	Filler
painter	Word	Filler
rigloriem	Nonword	Filler
meadow	Word	Filler
apple	Word	Filler
bipar	Nonword	Filler
napkin	Word	Filler
goming	Nonword	Filler
monsoon	Word	S-Final
tinogail	Nonword	Filler
carousel	Word	S-Final
librarian	Word	Filler
ladder	Word	Filler
medicine	Word	S-Final
prickpor	Nonword	Filler
arafimp	Nonword	Filler
mannequin	Word	Filler
diamond	Word	Filler
iglopad	Nonword	Filler
ladle	Word	Filler
shelter	Word	SH-Initial
tepple	Nonword	Filler
galaxy	Word	S-Final
cradle	Word	Filler
candy	Word	Filler
danoor	Nonword	Filler
usher	Word	SH-Final
mopial	Nonword	Filler
balrop	Nonword	Filler
hammertrent	Nonword	Filler
nonifem	Nonword	Filler
mural	Word	Filler
roppet	Nonword	Filler
omplero 	Nonword	Filler
thorkwift	Nonword	Filler
gamtee	Nonword	Filler
graffiti	Word	Filler
nometin	Nonword	Filler
poltira	Nonword	Filler
shoplifter	Word	SH-Initial
poara	Nonword	Filler
mogmet	Nonword	Filler
wapteep	Nonword	Filler
shiny	Word	SH-Initial
popcorn	Word	Filler
namittle	Nonword	Filler
golthin	Nonword	Filler
tortilla	Word	Filler
missile	Word	S-Final
buckle	Word	Filler
theely	Nonword	Filler
arnuff	Nonword	Filler
tissue	Word	SH-Final
goalie	Word	Filler
sugar	Word	SH-Initial
tovey	Nonword	Filler
follipocktel	Nonword	Filler
gondola	Word	Filler
tunnel	Word	Filler
taxi	Word	S-Final
acrobat	Word	Filler
bamboo	Word	Filler
patient	Word	SH-Final
glaple	Nonword	Filler
whistle	Word	S-Final
rinbel	Nonword	Filler
concert	Word	S-Final
bettle	Nonword	Filler
castle	Word	S-Final
inoret	Nonword	Filler
giptern	Nonword	Filler
tadpole	Word	Filler
neproyave	Nonword	Filler
tuddom	Nonword	Filler
talell	Nonword	Filler
dancer	Word	S-Final
pluepelai 	Nonword	Filler
teygot	Nonword	Filler
helicopter	Word	Filler
tractor	Word	Filler
lumber	Word	Filler
brahata	Nonword	Filler
butterfly	Word	Filler
feather	Word	Filler
prithet	Nonword	Filler
shoulder	Word	SH-Initial
impomo	Nonword	Filler
microwave	Word	Filler
elephant	Word	Filler
calendar	Word	Filler
bambany	Nonword	Filler
cursor	Word	S-Final
piano	Word	Filler
cashier	Word	SH-Final
tirrenper	Nonword	Filler
acorn	Word	Filler
gippelfraw	Nonword	Filler
wogim	Nonword	Filler
cushion	Word	SH-Final
lindel 	Nonword	Filler
fossil	Word	S-Final
apolm	Nonword	Filler
table	Word	Filler
gallmit	Nonword	Filler
radadub	Nonword	Filler
